

				EA ./walls/4k.XPM


							WE ./walls/floar_item.XPM
							SO ./walls/trapdoor_close.XPM

							NO ./walls/cat.XPM







F 17,180,227



C 1,2,255










111111111111111111111
110000000000000000001
100000000000000000001
100000000000000000001
100000000N00000000001
100000000000000000001
100000000000000000001
100000000000000000001
100000010000010000001
100000000000000000001
111111111111111111111
