SO ./walls/corner_down_left.XPM
NO ./walls/corner_down_left.XPM
WE ./walls/corner_down_left.XPM
EA ./walls/corner_down_left.XPM

F 1,2,255
C 1,2,2

11111111111
10000000101
10010000001
10000000001
10000S00001
10000000001
10000000001
11111111111
