SO ./walls/corner_down_left.XPM

NO ./walls/corner_down_left.XPM
   
WE ./walls/corner_down_left.XPM
       
EA ./walls/corner_down_left.XPM
   
F 1,2,a

C 1,2,2

        1111111111111111111111111
        1000000000110000000000001
        1011000001110000000000001
        1001000000000000000000001
111111111011000001110000000000001 
100000000011000001110111111111111
11110111111111011100000010001
11110111111111011101010010001
11000000110101011100000010001
1000000000000000110000N01001
10000000000000000011010100001
1100000111010101111101111000111
11110111 1110101 101111010001
11111111 1111111 111111111111